27,27,27,27,27,27,27,27,27,27,27,27,27,27,27,27,27,27,27,27,27,27,27,27,27,27,27,27,27,27,27,27,27,27,27,27,27,27,27,27,27,27,27,27,27,27,27,27,27,27,27,27,27,27,27,27,27,27,27,27,27,27,27,27
27,27,27,27,27,27,27,27,27,27,27,27,27,27,27,27,27,27,27,27,27,27,27,27,27,27,27,27,27,27,27,27,27,27,27,27,27,27,27,27,27,27,27,27,27,27,27,27,27,27,27,27,27,27,27,27,27,27,27,27,27,27,27,27
27,27,27,27,27,27,27,27,27,27,27,27,27,27,27,27,27,27,27,27,27,27,27,27,27,27,27,27,27,27,27,27,27,27,27,27,27,27,27,27,27,27,27,27,27,27,27,27,27,27,27,27,27,27,27,27,27,27,27,27,27,27,27,27
27,27,27,27,27,27,27,27,27,27,27,27,27,27,27,27,27,27,27,27,27,27,27,27,27,27,27,27,27,27,27,27,27,27,27,27,27,27,27,27,27,27,27,27,27,27,27,27,27,27,27,27,27,27,27,27,27,27,27,27,27,27,27,27
27,27,27,27,27,27,27,27,27,27,27,27,27,27,27,27,27,27,27,27,27,27,27,27,27,27,27,27,27,27,27,27,27,27,27,27,27,27,27,27,27,27,27,27,27,27,27,27,27,27,27,27,27,27,27,27,27,27,27,27,27,27,27,27
27,27,27,27,27,27,27,27,27,27,27,27,27,27,27,27,27,27,27,27,27,27,27,27,27,27,27,27,27,27,27,27,27,27,27,27,27,27,27,27,27,27,27,27,27,27,27,27,27,27,27,27,27,27,27,27,27,27,27,27,27,27,27,27
27,27,27,27,27,27,27,27,27,27,27,27,27,27,27,27,27,27,27,27,27,27,27,27,27,27,27,27,27,27,27,27,27,27,27,27,27,27,27,27,27,27,27,27,27,27,27,27,27,27,27,27,27,27,27,27,27,27,27,27,27,27,27,27
27,27,27,27,27,27,27,27,27,27,27,27,27,27,27,27,27,27,27,27,27,27,27,27,27,27,27,27,27,27,27,27,27,27,27,27,27,27,27,27,27,27,27,27,27,27,27,27,27,27,27,27,27,27,27,27,27,27,27,27,27,27,27,27
27,27,27,27,27,27,27,27,27,27,27,27,27,27,27,27,27,27,27,27,27,27,27,27,27,27,27,27,27,27,27,27,27,27,27,27,27,27,27,27,27,27,27,27,27,27,27,27,27,27,27,27,27,27,27,27,27,27,27,27,27,27,27,27
27,27,27,27,27,27,27,27,27,27,27,27,27,27,27,27,27,27,27,27,27,27,27,27,27,27,27,27,27,27,27,27,27,27,27,27,27,27,27,27,27,27,27,27,27,27,27,27,27,27,27,27,27,27,27,27,27,27,27,27,27,27,27,27
27,27,27,27,27,27,27,27,27,27,27,27,27,27,27,27,27,27,27,27,27,27,27,27,27,27,27,27,27,27,27,27,27,27,27,27,27,27,27,27,27,27,27,27,27,27,27,27,27,27,27,27,27,27,27,27,27,27,27,27,27,27,27,27
27,27,27,27,27,27,27,27,27,27,27,27,27,27,27,27,27,27,27,27,27,27,27,27,27,27,27,27,27,27,27,27,27,27,27,27,27,27,27,27,27,27,27,27,27,27,27,27,27,27,27,27,27,27,27,27,27,27,27,27,27,27,27,27
27,27,27,27,27,27,27,27,27,27,27,27,27,27,27,27,27,27,27,27,27,27,27,27,27,27,27,27,27,27,27,27,27,27,27,27,27,27,27,27,27,27,27,27,27,27,27,27,27,27,27,27,27,27,27,27,27,27,27,27,27,27,27,27
27,27,27,27,27,27,27,27,27,27,27,27,27,27,27,27,27,27,27,27,27,27,27,27,27,27,27,27,27,27,27,27,27,27,27,27,27,27,27,27,27,27,27,27,27,27,27,27,27,27,27,27,27,27,27,27,27,27,27,27,27,27,27,27
27,27,27,27,27,27,27,27,27,27,27,27,27,27,27,27,27,27,27,27,27,27,27,27,27,27,27,27,27,27,27,27,27,27,27,27,27,27,27,27,27,27,27,27,4,5,5,5,5,5,5,5,5,5,5,4,27,27,27,27,27,27,27,27
27,27,27,27,27,27,27,27,27,27,27,27,27,5,5,5,5,27,27,27,27,27,27,27,27,27,27,27,27,27,27,27,27,27,27,27,27,27,27,27,27,27,27,27,4,28,28,28,44,44,44,44,44,28,28,4,27,27,27,27,27,27,27,27
27,27,27,27,27,27,27,27,27,27,27,27,5,28,28,28,28,5,27,27,27,27,27,27,27,27,27,27,27,27,27,27,27,27,27,27,27,27,27,27,27,27,27,27,4,28,28,28,44,28,43,28,44,28,28,4,27,27,27,27,27,27,27,27
27,27,27,27,27,27,27,27,27,27,27,5,28,28,28,28,28,28,5,27,27,27,27,27,27,27,27,27,27,27,27,27,27,27,27,27,27,27,27,27,27,27,27,27,4,28,28,28,28,28,28,28,28,28,28,4,27,27,27,27,27,27,27,27
27,27,27,27,27,27,27,27,27,27,4,28,28,28,28,28,28,28,28,4,27,27,27,27,27,27,27,27,27,27,27,27,27,27,27,27,27,27,27,27,27,27,27,27,4,28,28,28,28,28,28,28,28,28,28,4,27,27,27,27,27,27,27,27
27,27,27,27,27,27,27,27,27,27,4,28,28,28,28,28,28,28,28,5,5,5,5,5,5,5,5,5,5,5,5,5,5,5,5,5,5,5,5,5,5,5,5,5,5,28,28,28,28,28,28,28,28,28,28,4,27,27,27,27,27,27,27,27
27,27,27,27,27,27,27,27,27,27,4,28,28,28,-1,28,28,28,28,28,28,28,28,28,28,28,28,28,28,28,28,28,28,28,28,28,28,28,28,28,28,28,28,28,28,28,28,28,44,44,44,44,44,28,28,4,27,27,27,27,27,27,27,27
27,27,27,27,27,27,27,27,27,27,4,28,28,28,28,28,28,28,28,4,4,4,4,4,4,4,4,4,4,28,4,4,4,4,4,4,4,4,4,4,4,4,4,4,4,28,28,28,28,28,28,28,28,28,28,4,27,27,27,27,27,27,27,27
27,27,27,27,27,27,27,27,27,27,4,28,28,28,28,28,28,28,28,4,27,27,27,27,27,27,27,27,4,28,4,27,27,27,27,27,27,27,27,27,27,27,27,27,4,28,28,28,28,28,28,28,28,28,28,4,27,27,27,27,27,27,27,27
27,27,27,27,27,27,27,27,27,27,27,4,28,28,28,28,28,28,4,27,27,27,27,27,27,27,27,27,4,28,4,27,27,27,27,27,27,27,27,27,27,27,27,27,4,28,28,28,28,28,28,28,28,28,28,4,27,27,27,27,27,27,27,27
27,27,27,27,27,27,27,27,27,27,27,27,4,28,28,28,28,4,27,27,27,27,27,27,27,27,27,27,4,28,4,27,27,27,27,27,27,27,27,27,27,27,27,27,4,28,28,28,44,28,43,28,44,28,28,4,27,27,27,27,27,27,27,27
27,27,27,27,27,27,27,27,27,27,27,27,27,4,4,4,4,27,27,27,27,27,27,27,27,27,27,27,4,28,4,27,27,27,27,27,27,27,27,27,27,27,27,27,4,28,28,28,44,44,44,44,44,28,28,4,27,27,27,27,27,27,27,27
27,27,27,27,27,27,27,27,27,27,27,27,27,27,27,27,27,27,27,27,27,27,27,27,27,27,27,27,4,28,4,27,27,27,27,27,27,27,27,27,27,27,27,27,4,4,4,4,4,4,4,4,4,4,4,4,27,27,27,27,27,27,27,27
27,27,27,27,27,27,27,27,27,27,27,27,27,27,27,27,27,27,27,27,27,27,27,27,27,27,27,27,4,28,4,27,27,27,27,27,27,27,27,27,27,27,27,27,27,27,27,27,27,27,27,27,27,27,27,27,27,27,27,27,27,27,27,27
27,27,27,27,27,27,27,27,27,27,27,27,27,27,27,27,27,27,27,27,27,27,27,27,27,27,27,27,4,28,4,27,27,27,27,27,27,27,27,27,27,27,27,27,27,27,27,27,27,27,27,27,27,27,27,27,27,27,27,27,27,27,27,27
27,27,27,27,27,27,27,27,27,27,4,5,5,5,5,5,5,5,5,5,4,27,27,27,27,27,27,27,4,28,4,27,27,27,27,27,27,27,27,27,27,27,27,27,27,27,27,27,27,27,27,27,27,27,27,27,27,27,27,27,27,27,27,27
27,27,27,27,27,27,27,27,27,27,4,28,28,28,28,28,28,28,28,28,4,27,27,27,27,27,27,27,4,28,4,27,27,27,27,27,27,27,27,27,27,27,27,27,27,27,27,27,27,27,27,27,27,27,27,27,27,27,27,27,27,27,27,27
27,27,27,27,27,27,27,27,27,27,4,28,44,44,28,28,28,44,44,28,4,27,27,27,27,27,4,5,5,28,5,5,5,4,27,27,27,27,27,27,27,27,27,27,27,27,27,27,27,27,27,27,27,27,27,27,27,27,27,27,27,27,27,27
27,27,27,27,27,27,27,27,27,27,4,28,44,44,28,28,28,44,44,28,4,27,27,27,27,27,4,28,28,28,28,28,28,4,27,27,27,27,27,27,27,27,27,27,27,27,27,27,27,27,27,27,27,27,27,27,27,27,27,27,27,27,27,27
27,27,27,27,27,27,27,27,27,27,4,28,28,28,28,43,28,28,28,28,4,27,27,27,27,27,4,28,44,28,28,44,28,4,27,27,27,27,27,27,27,27,27,27,27,27,27,27,27,27,27,27,27,27,27,27,27,27,27,27,27,27,27,27
27,27,27,27,27,27,27,27,27,27,4,28,44,44,28,28,28,44,44,28,4,27,27,27,27,27,4,28,28,28,28,28,28,4,4,4,4,4,4,4,4,4,4,4,4,4,4,4,4,27,27,27,27,27,27,27,27,27,27,27,27,27,27,27
27,27,27,27,27,27,27,27,27,27,4,28,44,44,28,28,28,44,44,28,4,27,27,27,27,27,4,28,28,28,28,28,28,28,28,28,28,28,28,28,28,28,28,28,28,28,28,28,4,27,27,27,27,27,27,27,27,27,27,27,27,27,27,27
27,27,27,27,27,27,27,27,27,27,4,28,28,28,28,28,28,28,28,28,4,27,27,27,27,27,4,28,28,28,28,28,28,4,4,4,4,4,4,4,4,4,4,4,4,4,4,28,4,27,27,27,27,27,27,27,27,27,27,27,27,27,27,27
27,27,27,27,27,27,27,27,27,27,4,28,28,28,28,28,28,28,28,28,4,27,27,27,27,27,4,28,44,28,28,44,28,4,27,27,27,27,27,27,27,27,27,27,27,27,4,28,4,27,27,27,27,27,27,27,27,27,27,27,27,27,27,27
27,27,27,27,27,27,27,27,27,27,4,4,4,4,28,4,4,4,4,4,4,27,27,27,27,27,4,28,44,28,28,44,28,4,27,27,27,27,27,27,27,27,27,27,27,27,4,28,4,27,27,27,27,27,27,27,27,27,27,27,27,27,27,27
27,27,27,27,27,27,27,27,27,27,27,27,27,4,28,4,27,27,27,27,27,27,27,27,27,27,4,28,28,28,28,28,43,4,27,27,27,27,27,27,27,27,27,27,27,27,4,28,4,27,27,27,27,27,27,27,27,27,27,27,27,27,27,27
27,27,27,27,27,27,27,27,27,27,27,27,27,4,28,4,27,27,27,27,27,27,27,27,27,27,4,4,4,28,4,4,4,4,27,27,27,27,27,27,27,27,27,27,27,27,4,28,4,27,27,27,27,27,27,27,27,27,27,27,27,27,27,27
27,27,27,27,27,27,27,27,27,27,27,27,27,4,28,4,27,27,27,27,27,27,27,27,27,27,27,27,4,28,4,27,27,27,27,27,27,27,27,27,27,27,27,27,27,27,4,28,4,27,27,27,27,27,27,27,27,27,27,27,27,27,27,27
27,27,27,27,27,27,27,27,27,27,27,27,27,4,28,4,27,27,27,27,27,27,27,27,27,27,27,27,4,28,4,27,27,27,27,27,27,27,27,27,27,27,27,27,27,5,5,28,5,5,27,27,27,27,27,27,27,27,27,27,27,27,27,27
27,27,27,27,27,27,27,27,27,27,27,27,27,4,28,4,27,27,27,27,27,27,27,27,27,27,27,27,4,28,4,27,27,27,27,27,27,27,27,27,27,27,27,5,5,28,28,28,28,28,5,5,27,27,27,27,27,27,27,27,27,27,27,27
27,27,27,27,27,27,27,27,27,27,27,27,27,4,28,4,27,27,27,27,27,27,27,27,27,27,27,27,4,28,4,27,27,27,27,27,27,27,27,27,27,27,5,28,28,28,28,28,28,28,28,28,5,27,27,27,27,27,27,27,27,27,27,27
27,27,27,27,27,27,27,27,27,27,27,27,27,4,28,4,27,27,27,27,27,27,27,27,27,27,27,27,4,28,4,27,27,27,27,27,27,27,27,27,27,4,28,28,28,28,28,28,28,28,28,28,28,4,27,27,27,27,27,27,27,27,27,27
27,27,27,27,27,27,27,27,27,27,27,27,27,4,28,4,27,27,27,27,27,27,27,27,27,27,27,27,4,28,4,27,27,27,27,27,27,27,27,27,27,5,28,28,28,28,28,28,28,28,28,28,28,5,27,27,27,27,27,27,27,27,27,27
27,27,27,27,27,27,27,27,27,4,5,5,5,5,28,5,5,5,4,27,27,27,27,27,27,27,27,27,4,28,4,27,27,27,27,27,27,27,27,27,4,28,28,28,28,28,28,28,28,28,28,28,28,28,4,27,27,27,27,27,27,27,27,27
27,27,27,27,27,27,27,27,27,4,43,28,28,28,28,28,28,28,4,27,27,27,27,27,27,27,27,27,4,28,4,27,27,27,27,27,27,27,27,27,4,28,28,28,28,28,28,28,28,28,28,28,28,28,4,27,27,27,27,27,27,27,27,27
27,27,27,27,27,27,27,27,27,4,28,44,44,28,28,28,44,28,4,27,27,27,27,27,27,27,27,27,4,28,4,27,27,27,27,27,27,27,27,27,4,28,28,28,28,28,28,45,28,28,28,28,28,28,4,27,27,27,27,27,27,27,27,27
27,27,27,27,27,27,27,27,27,4,28,44,44,28,28,28,44,28,4,27,27,27,27,27,4,5,5,5,5,28,5,5,5,5,4,27,27,27,27,27,4,28,28,28,28,28,28,28,28,28,28,28,28,28,4,27,27,27,27,27,27,27,27,27
27,27,27,27,27,27,27,27,27,4,28,28,28,28,28,28,28,28,4,27,27,27,27,27,4,43,28,28,28,28,28,28,28,28,4,27,27,27,27,27,4,28,28,28,28,28,28,28,28,28,28,28,28,28,4,27,27,27,27,27,27,27,27,27
27,27,27,27,27,27,27,27,27,4,28,28,28,28,28,28,28,28,4,27,27,27,27,27,4,28,44,44,28,28,28,44,44,28,4,27,27,27,27,27,27,4,28,28,28,28,28,28,28,28,28,28,28,4,27,27,27,27,27,27,27,27,27,27
27,27,27,27,27,27,27,27,27,4,28,44,44,28,28,28,28,28,4,27,27,27,27,27,4,28,44,44,28,28,28,44,44,28,4,27,27,27,27,27,27,4,28,28,28,28,28,28,28,28,28,28,28,4,27,27,27,27,27,27,27,27,27,27
27,27,27,27,27,27,27,27,27,4,28,44,44,28,28,28,28,28,5,5,5,5,5,5,5,28,28,28,28,28,28,28,28,28,4,27,27,27,27,27,27,27,4,28,28,28,28,28,28,28,28,28,4,27,27,27,27,27,27,27,27,27,27,27
27,27,27,27,27,27,27,27,27,4,28,28,28,28,28,28,28,28,28,28,28,28,28,28,28,28,28,28,28,28,28,28,28,28,4,27,27,27,27,27,27,27,27,4,4,28,28,28,28,28,4,4,27,27,27,27,27,27,27,27,27,27,27,27
27,27,27,27,27,27,27,27,27,4,28,28,28,28,28,28,28,28,4,4,4,4,4,4,4,28,44,44,28,28,28,44,44,28,4,27,27,27,27,27,27,27,27,27,27,4,4,4,4,4,27,27,27,27,27,27,27,27,27,27,27,27,27,27
27,27,27,27,27,27,27,27,27,4,28,44,44,28,28,28,44,28,4,27,27,27,27,27,4,28,44,44,28,28,28,44,44,28,4,27,27,27,27,27,27,27,27,27,27,27,27,27,27,27,27,27,27,27,27,27,27,27,27,27,27,27,27,27
27,27,27,27,27,27,27,27,27,4,28,44,44,28,28,28,44,28,4,27,27,27,27,27,4,28,28,28,28,28,28,28,28,28,4,27,27,27,27,27,27,27,27,27,27,27,27,27,27,27,27,27,27,27,27,27,27,27,27,27,27,27,27,27
27,27,27,27,27,27,27,27,27,4,28,28,28,28,28,28,28,28,4,27,27,27,27,27,4,4,4,4,4,4,4,4,4,4,4,27,27,27,27,27,27,27,27,27,27,27,27,27,27,27,27,27,27,27,27,27,27,27,27,27,27,27,27,27
27,27,27,27,27,27,27,27,27,4,4,4,4,4,4,4,4,4,4,27,27,27,27,27,27,27,27,27,27,27,27,27,27,27,27,27,27,27,27,27,27,27,27,27,27,27,27,27,27,27,27,27,27,27,27,27,27,27,27,27,27,27,27,27
27,27,27,27,27,27,27,27,27,27,27,27,27,27,27,27,27,27,27,27,27,27,27,27,27,27,27,27,27,27,27,27,27,27,27,27,27,27,27,27,27,27,27,27,27,27,27,27,27,27,27,27,27,27,27,27,27,27,27,27,27,27,27,27
27,27,27,27,27,27,27,27,27,27,27,27,27,27,27,27,27,27,27,27,27,27,27,27,27,27,27,27,27,27,27,27,27,27,27,27,27,27,27,27,27,27,27,27,27,27,27,27,27,27,27,27,27,27,27,27,27,27,27,27,27,27,27,27
27,27,27,27,27,27,27,27,27,27,27,27,27,27,27,27,27,27,27,27,27,27,27,27,27,27,27,27,27,27,27,27,27,27,27,27,27,27,27,27,27,27,27,27,27,27,27,27,27,27,27,27,27,27,27,27,27,27,27,27,27,27,27,27
